                         *
                         *
     =   =            =  *
     =   =     =      =  *
     =         =      =  *
   ====        =      =  *
   =     =     =      =  *
   =     =     =      =  *
   =     =          ===  *
   =     =               *
                         *
               ====      *
               =         *
               =         *
               =         *
            =            *
            =            *
  =====     =   ==       *
            =    =       *
                 =       *
         =       ===     *
         =               *
         ====            *
                         *
                         *





