                         *
                         *
                         *
                         *
                         *
         =====           *
         =       =       *
   =     =       =       *
   =     =       =       *
   =     =       =   =   *
   =     =       =   =   *
   =             =   ====*
   =             =   =   *
      =====      =   =   *
          =     ==       *
          =              *
                         *
    =                    *
    =  =        ====     *
    =  =           =     *
    =  =====             *
    =                    *
                         *
                   =     *
                   =     *



