                         *
                         *
        =====      =     *
            =      =     *
    =       =      =     *
    =       =      ====  *
    ====                 *
                         *
               =         *
   ====        =         *
     =         =      ===*
     =                =  *
     =                   *
     =  =                *
     =  =  =========     *
        =                *
        =                *
        =           ==   *
     =        =      =   *
     =       =====   ==  *
     =                   *
     =                   *
     =======             *
                         *
                         *




